 ____    ____       _       ________  ________     ______       _       ____    ____  ________  
|_   \  /   _|     / \     |  __   _||_   __  |  .' ___  |     / \     |_   \  /   _||_   __  | 
  |   \/   |      / _ \    |_/  / /    | |_ \_| / .'   \_|    / _ \      |   \/   |    | |_ \_| 
  | |\  /| |     / ___ \      .'.' _   |  _| _  | |   ____   / ___ \     | |\  /| |    |  _| _  
 _| |_\/_| |_  _/ /   \ \_  _/ /__/ | _| |__/ | \ `.___]  |_/ /   \ \_  _| |_\/_| |_  _| |__/ | 
|_____||_____||____| |____||________||________|  `._____.'|____| |____||_____||_____||________| 
                                                                                                